                        < >                     
                         |                      
1B      ( )-( )-( )-( )-[*]-( )-( )-( )-( )     
         |                               |      
1B      ( )-( )-( )-{ }-[*]-{ }-( )-( )-( )     
                         |                      
1B          ( )-( )-[*]-( )-[*]-( )-( )         
             |                       |          
0B          { }-[*]-( )-( )-( )-[*]-{ }         
                         |                      
0B              ( )-( )-{ }-( )-( )             
                 |       |       |              
                 |      <1>      |              
                 |               |              
0B  { }-( )-{ }-( )-( )-{ }-( )-( )-{ }-( )-{ } 
     |       |           |           |       |  
0-  ( )-( )-( )-( )-( )-( )-( )-( )-( )-( )-( ) 
         |       |               |       |      
    <R>-<R>     <G>-<G>     <Y>-<Y>     <B>-<B> 
     |   |       |   |       |   |       |   |  
    <R>-<R>     <G>-<G>     <Y>-<Y>     <B>-<B> 